NO 				textures/wall1.xpm
SO             textures/wall1.xpm
WE 				textures/wall2.xpm
EA    textures/wall2.xpm

F 			12, 255, 255
   C		34, 23                  , 35

1111111111111111111111111
1000000000110000000000001
1011000001110000000000001
1001000000000000000000001
11111111101100000111000011
100000000011000001110111111111111
1111011111111101110000001000111
11110111111111011101010010001
11000000110101011100000010001
10000000000000001100000010001
10000000000000001101010010001
10000011111010111110111000N11
11110111 1110101 101111010001
   11111 1111111 111111111111

