NO 				textures/wall1.xpm
SO             textures/wall1.xpm
WE 				textures/wall2.xpm
EA    textures/wall2.xpm

F 			12, 255, 255
   C		34, 23                  , 35

1111111111111111111111111
1000000000110000000000001
1011000001110000000000001
1001000000000000000000001
1111111110110000011100001111111
100000000011000001110111111101111
1111011111111101110000001000111
11110111111111011101010010001
11000000110101011100000010001
10000000000000001100000010001
10000000000000001111010010001
10000011111010111100111000N11
11110111 11101011001111010001
   11111 11111111111111111111

