NO 				textures/wall_morgul.xpm
SO             textures/wall_morgul.xpm
WE 				textures/wall_morgul.xpm
EA    textures/wall_morgul.xpm

F 			85, 202, 173
   C		34, 23                  , 35

1111111111111111111111111
1000000000110000000000001
1011000001110000000000001
1001000000000000000000001
1111111110110000011100001111111
10000000001100000111D111111101111
11110111111111011100000010D0111
11110111111111011101D10010D01
1100000011010101110000001ADA1
10000000000000001100000010001
10000000000000001101010010001
100000111110101111101110D0S11
11110111 1110101 101111010001
   11111 1111111 111111111111
