NO	textures/no_texture
SO	textures/ea_texture
WE	textures/we_texture
EA	textures/ea_texture

F	12, 255, 255
C	34, 23, 35

1111111111
1010000001
1010000001
1010000101
1010000001
10000N0001
1111111111