NO 				textures/wall1.xpm
SO             textures/wall1.xpm
WE 				textures/wall2.xpm
EA    textures/wall2.xpm

F 			12, 255, 255
   C		34, 23                  , 35

111111111
111111111
111100001
100000001
100000001
111111111
111111111
111111111
111100001
100000001
1000000N1
111111111
